


EA ./wall_txt/Blue19.xpm
NO ./wall_txt/Blue19.xpm
SO ./wall_txt/Blue19.xpm
WE ./wall_txt/Blue19.xpm

F 220,100,2
C 0,0,0









111111111111111
101000000000W01
100100010000001                  111111111
100000111001101111111111111111111100000001
100111000000100000000000000000000D00000001
100000000000111111111111111111111100000001
1111000000000111                 111111111
11000000000001
11111111111111