111111111
100000001
100000001
1000D0001
1000D0001
1000D0001
1000D0001
1111D1111
100000001
1000N0001
111111111