111111111
100000001
1111D1111
1000000W1
111111111