111111111
100000001
1000D0001
1000000N1
111111111