111111111111111
101000000000W01
100100010000001
100000111000001
100111000000001
1000000000000111
1111000000000111
 11000000000001
111111111111111111