111111111111111
100100000000001
100100010000001
100000111000001
100111000000001
100000000000001
000000000000001111
11110000000001111
    1W000000000001
111111111111111111