EA ./wall_txt/Brown8.xpm
NO ./wall_txt/Brown1.xpm
SO ./wall_txt/Brown3.xpm
WE ./wall_txt/Brown6.xpm

F 220,100,2
C 225,30,2.

111111111111111
101000000000W01
100100010000001
100000111000001
100111000000001
100000000000111
1111000000000111
11000000000001
111111111111111111
