
NO ./wall_txt/Brown1.xpm
SO ./wall_txt/Brown3.xpm
WE ./wall_txt/Brown6.xpm
EA ./wall_txt/Brown8.xpm
F 220,100,2

C 225,30,2


111111111111111111111111111111111111111
100000000000000000000000000000000000001
111111111111111111111111111111111111101
                                    101
                                    101
                                    101
                                    101
                                    101
                                    101
                                    101
111111111111111111111111111111111111101
1E0000000000000000000000000000000000001
111111111111111111111111111111111111101
                                    101
                                    101
                                    101
                                    101
                                    101     111111
                                    10111   100001
                                    10100111100001
                                    10D00000000001
                                    10100111100001      
                                    10111   100001
                                    101     100001
                                    10111111101111
                                    101     101
                                    101  111001
                                    1011100D001
                                    10D00001111
                                    11111111