
1111111
10S0001
1000001
1111111