NO ./wall_txt/Black5.xpm
SO ./wall_txt/Black5.xpm
WE ./wall_txt/Black5.xpm
EA ./wall_txt/Black5.xpm
F 220,100,2

C 225,30,2
11111111111111111111111111         
111100000000000N0000001111111      
   10000000000000010000000000111     
 1100000000000000000000001111
11111110111111111111111111
    111D11
111111101111111111111111
10000000000000000000000011
 10000000000011100000000001
  100000000001 100000000001
   1000000000111000000000001
  1000000000000000000000001
 1000000000000000000000001
1111111111111111111111111
