    1111111111111111111111111         
   1N000000000000000000001      
  1000000000000001000000001      
 1000000000000000000000001
1000000000000000000000001
 1000000000001000000000001
  1000000000000000000000001
   1000000000000000000000001
  1000000000000000000000001
 1000000000000000000000001
1111111111111111111111111