NO ./wall_txt/Black5.xpm
SO ./wall_txt/Black5.xpm
WE ./wall_txt/Black5.xpm
EA ./wall_txt/Black5.xpm
F 220,100,2

C 225,30,2
111111111
100000001
100000001
100000001
100000001
100000001
100000001
1111D1111
100000001
1000N0001
111111111